+-+-------+-----+
| |       |     |
| + ---   +  --++
|               |
+--  +-+    +---+
|    |      |   g
|  ---+--  +   -+
|           |   |
+-  -------+-- -+
|  +            |
|  +---- ----- -+
|               |
+---------------+